222222222222222222222222222222
222222222222222222222222222222
231111111111111111111111111112
211111111111111111111111111112
211111111111111111111111111112
211111111111111111111111111112
211111111111111111111111111112
211111111111119111111111111112
211111111111111111111111111112
211111111111111111111111111112
211111111111111111111111111112
211111111111111111111111111112
211111111111111111111111111112
211111111111111111111111111112
211111111111111111111111111172
222222222222222222222222222222
222222222222222222222222222222