222222222222222222222222222222
222222222222222222222222222222
211111111111111111111411111112
211114111111411111111411114112
214114111211111131111111114112
211114111111411111111411114112
211164111111411111111111114112
211111111111111111111411111112
211114511111111111111111114112
211114111111411111111411114112
211111111111411111111411114112
211114111111411161111411111112
211114111111111111111411114112
211114111111411111111411114112
211114111111411111111411114112
222222222222222222222222222222
222222222222222222222222222222