222222222222222222222222222222
222222222222222222222222222222
211111111111111111111111111112
211111111111111111111111111112
211111111111111111111111111112
211111111111111111511111111112
211141111111111111611111111112
231141111111111111511111111112
211141111111111111611111111112
211111111111111111511111111112
211111111111111111111111111112
211111111111111111111111111112
211111111111111111111111111112
211111111111111111111111111112
211111111111111111111111111112
222222222222222222222222222222
222222222222222222222222222222