222222222222222222222222222222
222222222222222222222222222222
211111111111111111111111111172
211111111111111111111111111112
211111111111111111111111111112
211111111111111111111111111112
211111111111111111111111111112
211111111111111111111111111112
231111111111111111111111111112
211111111111111111111111111112
211111111111111111111111111112
211111111111111111111111111112
211111111111111111111111111112
211111111111111111111111111112
211111111111111111111111111172
222222222222222222222222222222
222222222222222222222222222222