222222222222222222222222222222
222222222222222222222222222222
271111111111118111111111111172
211111111111111111111111111112
211111111111111111111111111112
211111111111111111111111111112
211111111111122111111111111112
211111111111111111111111111112
211111111111113111111111111112
211111111111111111111111111112
211111111111112211111111111112
211111111111111111111111111112
211111111111111111111111111112
211111111111111111111111111112
271111111111118111111111111172
222222222222222222222222222222
222222222222222222222222222222