222222222222222222222222222222
222222222222222222222222222222
261111111111141314111111111162
211111111151141114115111111112
211111111111141114111111111112
211111111111111111111111111112
211111111111111111111111111112
211141111111111111111111141112
211114111111111111111111411112
211714115111111111111511417112
211114111111111111111111411112
211111111111111111111111111112
214411111111111111111111114412
211411111111111111111111114112
261111111111111111111111111162
222222222222222222222222222222
222222222222222222222222222222