222222222222222222222222222222
222222222222222222222222222222
231145111111611161111111114172
211141111111111111111111111112
211111411114411144111111114142
244141111111111111111111111112
251111111111111111111111411162
211411111111411111111111411112
211111111111411111111111111112
211111111111411111111111411162
211111111111411111111111411112
211111111111111111111111111112
214111111111111111111111111412
211111111111111111111111111112
271411111111111111111111114172
222222222222222222222222222222
222222222222222222222222222222