222222222222222222222222222222
222222222222222222222222222222
271111111111118111111111111172
211111111111111111111111111112
211111111111111111111111111112
211111111111111111111111111112
211111111112222111111111111112
211111111111111111112111111112
281111112111113111112111111182
211111112111111111111111111112
211111111111112222111111111112
211111111111111111111111111112
211111111111111111111111111112
211111111111111111111111111112
271111111111118111111111111172
222222222222222222222222222222
222222222222222222222222222222