222222222222222222222222222222
222222222222222222222222222222
271111111111118111111111111172
211911111111111111111111111112
211111111111111111111111111112
211111111111111111111111111112
211111111112222222211111111112
211111112111111111112111111112
281111112111113111112111111182
211111112111111111111111111112
211111111111112222111111111112
211111111111111111111111111112
211111911111111111112222111112
211111111111111111111911111112
271111111111118111111111111172
222222222222222222222222222222
222222222222222222222222222222