222222222222222222222222222222
222222222222222222222222222222
291111114711115111111111151192
211111184111111111111181111112
211111114111171111111444711112
211511111111144111511111111112
211111111111114111111111111112
211111111117411146111111711112
211511144411413147111114441112
211111118111411141111111811112
211111111111114111111511111112
271151111111114411111111111112
244111111111111711114111111112
211114111115111111164711111112
291114611111111111114111111192
222222222222222222222222222222
222222222222222222222222222222