222222222222222222222222222222
222222222222222222222222222222
291111114911119111111111191192
211111194111111111111191111112
211111114111191111111444911112
211911111111144111911111111112
211111111111114111111111111112
211111111119411149111111911112
211911144411413149111114441112
211111119111411141111111911112
211111111111114111111911111112
291191111111114411111111111112
244111111111111911114111111112
211114111119111111194911111112
291114911111111111114111111192
222222222222222222222222222222
222222222222222222222222222222